99,99,99,99,99,99,99,99,99,99,99,99,
99,1,4,4,4,4,4,4,4,4,10,3,99
99,5,2,2,2,2,2,2,2,15,15,6,99
99,5,2,2,13,14,2,2,2,2,2,6,99
99,5,2,2,6,5,2,2,2,2,2,6,99
99,5,2,2,6,5,2,2,2,2,2,6,99
99,5,89,2,6,5,79,2,79,2,79,6,99
99,7,9,9,8,7,9,9,9,9,9,8,99
99,99,99,99,99,99,99,99,99,99,99,99,
