99,99,99,99,99,99,99,1,4,4,4,4,4,3,99,99,99
99,99,99,99,99,99,99,5,2,2,2,2,2,6,99,99,99
99,99,99,99,99,99,99,5,2,2,2,2,2,6,99,99,99
99,99,99,99,99,99,99,5,2,2,2,2,2,6,99,99,99
99,1,4,4,4,10,11,1,2,2,2,2,2,12,4,3,99
99,5,2,2,2,2,2,2,2,2,2,2,2,2,2,6,99
99,5,2,2,89,2,2,2,2,2,2,2,2,2,2,6,99
99,5,2,2,2,2,2,2,2,2,2,2,2,2,2,6,99
99,5,2,2,2,2,2,2,2,2,2,2,2,2,2,6,99
99,5,2,2,2,2,2,2,2,2,2,2,2,2,2,6,99
99,7,9,9,9,9,9,9,9,9,9,9,9,9,9,8,99
99,99,99,99,99,99,99,99,99,99,99,99,99,99,99,99,
